////////////////////////////////
////////////////////////////////
//////////////////////////*/////
////////////////////////////////
////////////////////////////////
/////*/////////////////#######//
///////////////////////#/////#//
///////////////////////#/////#//
[#############/////////#/////##]
/////////////#///*/////#/*//////
///////*/////#/////////#////////
/////////////#/////////#////////
/////////////###########////////
////////////////////////////////
///////////////*////////////////
////////////////////////////////
////////////////////////////////
////////////////////////////////