////////////////////////////////
////////////////////////////////
////////////////////////////////
//////////////////////////*/////
////////////////////////////////
///////////////////////#######//
/////*/////////////////#/////#//
///////////////////////#/////#//
[#############/////////#/////##]
/////////////#/////////#/*//////
///////*/////#///*/////#////////
/////////////#/////////#////////
/////////////###########////////
////////////////////////////////
///////////////*////////////////
////////////////////////////////
////////////////////////////////
////////////////////////////////