////////////////////////////////
////////////////////////////////
//////////////////////////*/////
////////////////////////////////
////////////////////////////////
/////*/////////////////#######//
///////////////////////#/////#//
///////////////////////#/*///#//
[#############/////////#/////##]
/////////////#///*/////#////////
///////*/////#/////////#////////
/////////////#/////////#////////
/////////////###########////////
/////////////////////*//////////
///////////////*////////////////
////////////////////////////////
////////////////////////////////
////////////////////////////////